###################
# #   #  #       ##
# # ### ## #####  B
# #     ## ###### #
# ## ##### #      A
#            ######
###################
