########################
#A###   #   #      ### #
# ### # # ##  # ## #   #
#  ## # # #  #   # # # #
## #  #   ## # # # # # B
#    ### #   ### # # ###
# ##   # # # # # # #   #
# ######## # # # # ### #
#          #   ###     #
########################